-------------------------------
-V............................-
-..--.----------.---.----.--..-
--....----------.---.----.--.--
--.--.-----......---.----.--.--
--.--.-----.--------.----.--.--
--.--.-----....-----.----.--.--
--....-------........----....--
-..--..------.------...------.-
-.----............----........-
-......................--------
-------------------------------